5 5
## ##
#   #
#   #
#   #
#####